SSSSSSSSSSSSSSSSSSSSSSSSS
SUUUUUUUUUUUUUUAV###WA..S
S...........###AV...WA..S
S..............AV...WA..S
S..###.##......AV...WA--S
SQ......Q...^^^AV....A..S
S..............AV.......S
S......^^......AV^^^....S
S..............AV.......S
S..............AV....A..S
A......##......AV....A..S
H........KGM...AV...WA..S
H........FAH...AV...WA..S
HDD^^^DDDFAH.....###WA..S
H..###...FAH.........A..S
H........FAH###......A..*
H.1......FAH.........A..*
H........FAH...KM....A..*
AGGGGGGGGAAATTTFAGGGGGGGA
