SV......WSV............WS
SV------WSV------------WS
SV......WSV............WS
SV......WSV............WS
SV......WSV............WS
SV......WSV............WS
SV......WSV............WS
SV......WSV............WS
SV......WSV............WS
SV......WSV......T.....WS
SS.......U......WSV....WS
S...............WSV....WS
S...............WSV....WS
S...............WSV....WS
S1..............WSV....WS
S...............WSV....WS
SS..............WSV....WS
SS..............WSV....WS
SS--------------WSV****WS
