SSSSAARRRSARSAARSARSRSRSR
PDDDDMUUUUUUUUUUUUUUUARSR
CPDDMC...............ARRR
CODDNC................PDM
ODDDDN...###...###....CAC
S........^^^..........CAC
S.....................CAC
S.....................CAC
S.....................CAC
S.1...................CAC
S.....................CAC
ARRRR.................ODN
S..............^^^......*
S........##....###......*
S.......................*
S............T..........*
S...........WAV.........*
S............U..........*
A------------------------
