SSSSSSSSSSSSSSSSSSSSSSSSS
SSADDDDDDDDDDDDDDDDDDDASS
SAN...................OAS
SC.....................CS
SC---------------------CS
SC.....................CS
SC...#.......5.......#.AD
SC......................*
SC......................*
SC.1....................*
SC...#..4...#.#..4...#.AD
SCRR...................CS
SCRR-------------------CS
SC.....................CS
SC.....................CS
SC.....................CS
SAM...................PAS
SSADDDDDDDDDDDDDDDDDDDASS
SSSSSSSSSSSSSSSSSSSSSSSSS
