CSSSSSSSSSSSSSSSSSSSSSSSC
ADDDDDDDDDDDDDDDDDDDDDDDA
C....###UUUUUU###.......C
C.......................C
C..............6........C
C.......................B
C.......................*
C.1.....................*
C.......................*
AGGGL...KGGGGL...KGGGGGGG
....H.6.F....H...F.......
....H...F....H...F.......
....H###F....H###F.......
....HTTTF....HTTTF.......
....AGGGA....AGGGA.......
....Q..QQ....Q...Q.......
....Q..QQ....Q...Q.......
....QQ.QQ....Q...Q.......
....QQQQQ.Q..QQQQQ.......
