AEEEEEEEEEEEEEEEEEEEEEEEA
H.......UUU.......UUUUUUF
H.1.....................F
H..#.4....#.#..4...#....F
AGL.....................F
RRALT........T..........F
EEAALT.AAARRALT..KAL....F
UUJAALTAAAEEAALTKAAI....F
*.UJAAGA...UJAAGAAIU....F
*...JARA....UJARAIU.....F
*....JEI.....UJEEI......F
*..#.....5...#...#.4...#F
*.......................F
*....#......4..#........F
*.......................F
GGGGL...................A
RRRRH......KGGGGL.......R
RRRRH.....TFRRRRHT.AAAARR
RRRRAGGLTTKARRRRALTAAARRR
